1111111111111111111111111111
1P0000000100000C10000C000011
101110111C111011101110101011
100000001000000000C000000011
1010111010111010111011101C11
100C0000000000001000E0000011
1111111111111111111111111111