1111111111111111111111111111111111
1100000000000000000000000000000011
10100101001000001010010000C0010111
1010010010101010001001000000010101
1P00000000000000000000000100000011
1111111111111111111111111111111111