111111111111111111111111111
1100000000000000100000000P1
101001011110001010100100001
101001001010101000100000001
1000E00000100000101C1000011
111111111111111111111111111