1111111111111111111111111111111111
1100000000000000000000000000000011
10100101P01000E01010010000C0010111
1010010010101010001001000000010101
1000000000100000101C10000100000011
1111111111111111111111111111111111