1111111111111111111111111111
110000000P000000100000C00111
1111010111100010101101001C11
1C11010C1010101000100E000011
10000000001C0000101C10000111
1111111111111111111111111111